*********************
*      4* - -5*0*  S*
* *** *** * *** * ***
* * *     *     * *9*
* * *********** * * *
* *     *   *7*   * *
* * *** * * *-*****-*
* - *M* * *         *
***** * * *****-*** *
*     *     *   *   *
* ***-***** * *** ***
* *8  * * *1* *M  *3*
* *** * * *** ***** *
*   *       *     * *
*** ******* ***** * *
*     *     *   * -M*
* ***** ***** * * ***
*   * - *     * * *2*
*** * * * ***** * * *
E   *6*      M* -   *
*********************
