*******************
*S*              M*
* * *** *-*********
*   *   *         *
* *** ********* * *
* *3  *       *1* *
* *****-***** *** *
*   *       * * - *
*** * ***** * * * *
*   * *   * * * * *
*** * * * * * * * *
*   *   * *4*   * *
* ******* *********
*     - * *       *
***** * * * ***** *
*  0* * * - *   * *
* *** * ***** * * *
*     *       *2* E
*******************
