-----------------------------------------
-      ----------------------------------
-      -------                   --------
-      -------                   --------
-   ----------   -------------   --------
-   ----------   -           -   --------
-   ----------   -------     -          -
-                       -    -          -
-                       -    ------------
-------   ---------------    ------------
-------   ---------------    ------------
-------   -------------------------------
-----------------------------------------
-----------------------------------------