-----------------------------------------
-      ----------------------------------
-      -------                   --------
-      -------                   --------
-   ----------   -------------   --------
-   ----------   -           -   --------
-   ----------   -------     -          -
-                            -          -
-                            ------------
-------   ---------------    ------------
-------   ---------------    ------------
-------   ---------------    ------------
-------                      ------------
-----------------------------------------
