********************
          *      - *
********* * **** * *
*       * *    * * *
* *****   **** * * *
*   *X***** X* * * *
* * * *   * ** * * *
* * * * * *    * * *
* * * * * ****** * *
* * * * *   *    * *
* *   * *** *-**** *
* *****   * *    * *
* *   *** * **** * *
* * *  X* *   X* * *
* * * ***-****** * *
* - *            * E
********************
