********************
          *        *
********* * **** * *
*       * *    * * *
* *****   **** * * *
*   * *****  * * * *
* * * *   * ** * * *
* * * * * *    * * *
* * * * * ****** * *
* * * * *   *    * *
* *   * *** * **** *
* *****   * *    * *
* *   *** * **** * *
* * *   * *    * * *
* * * *** ****** * *
*   *            *
********************
